##############################
#=====###==#====######==#==###
####===###=####===#####===####
##===#=====####=###==###=##==#
###=###=######========##=###=#
###=#=#=#########==##=##=##==#
###===#==########=###====###=#
##==####===###====####==####=#
##==#####==######=#####=####=#
###=######=######=#####=####=#
##==######=###====#####=###==#
###=###====####==######=====##
##======########=###==###==###
###=###=====#====####=###=#==#
##===#==###===##==##==###=#=##
###==#=#==#==####=====#=====##
#===##=#=#==#######==###====##
##==##=======#======####==#=##
#======#####===####======##==#
==============================